Eliminate - Weeble Wobble
Phiso - Pattern Screamer
BLVNKSPVCE - Beepy Boop Song
Knife Party - Centipede
Moore Kismet & Tasha Baxter - Call of the Unicorn
Gladez & HEKLER - 404
Ray Volpe - Battle of the Bros
Ace Aura - Coma
Jub - Beans
Bukez Finest - Duck Trumpet
qwaston - leave me alone
Phaseone & Northlane - Crash & Burn
DMVU - BLOCCD
Marauda - Casket
Convexity - Lattice
Aweminus - Sea Shanty
Tristam & Braken - Flight
Bommer & Crowell - Yasou
Infekt - Orgalorg
Zomboy - Like A Bitch
Dani Demand - Need Your Love
AFK, Carbin, Cody Ray - Boss
Ace Aura, Skybreak, & Sharks - Another Heart
FuntCase & Virtual Riot - Borg
G Jones - Fuck What You Heard
Spass - Hi Tek
JoeB - Petrol For Dinner
TroyBoi & Skrillex - WARLORDZ
Neonix - Spacewalk
Riddim Girl - Oolacile
Gammer - The Drop
Au5 - Cryptochrome
Excision, ILLENIUM, & Shallows - Gold (Stupid Love)
Barely Alive - Wompum
Phonon - Polyriddim
Veer - Jerk Off
Automhate - Tonal Riddim
Fox Stevenson - Miss You
Space Laces - D.A.W.
Hukae - Dirty Talk
Subfiltronik - Passout
Chime - Phototropic
Boombox Cartel & Quix - Supernatural
Versa - Welcome Tune
Griz & Subtronics - Griztronics
Barely Alive, Nyptane, and XO ELIZA - Electric Lady
Azabim, Cybertr0n, & Glockz - Jagerwomb
Tha Trickaz & Creaky Jackals - OG Purp
Akeos & Jub - Duel
Virtual Riot & Virus Syndicate - Show Up
Ray Volpe - Outerworld
Jeto & Will Stetson - Reaching Out
SVDDEN DEATH - Behemoth
Xilent - The Darkness
Leotrix - Hive Bounce
Devath - Chiptune
Oliverse - Get High
Hukae - Task Manager
Apashe - Uebok
Space Laces & Watch - Not Bees

All I Want - Franky Nuts
BADBOI - Xaebor
Big Riddim Monsta - Dodge & Fuski
Bye - Trinergy
Can't Sleep Alone At Night - Leotrix
Chicken Soup - Skrillex & Habstrakt
Coconut - Beutnoise & SEED
Confusion Spell - SVDDEN DEATH
Core - RL Grime
Crust and Jelly - Chibs
Death Pit - Marauda
Dummo Loop - WAVEDASH
Energy Drink - Virtual Riot
Escape - Moore Kismet
Flatline - Hydraulix
FOLLOW THE VIBE - LSDREAM & Taylr Renee
Papa Khan & Brave - Fall Apart
Gimme Some - Oski
Goin' Ham - Syzy
Head Crush - BadKlaat
Here It Comes - Pegboard Nerds
I WARE HOUSE - JOYRYDE
Indigo Plateau - Psychic Type
Keyboard Killer - Barely Alive & Splitbreed
Lift Off - Dirt Monkey
Lullaby - Sharks
Lunar Tear - Kotori
MOORG - Automhate
Noddin' - Ace Aura & Millennial
Our Moving Picture - Skybreak
Planet Purge - EH!DE & Midnight Tyrannosaurus
Poopo - Neonix
Preset Junkies - Virtual Riot
Resonator Trend Machine - Kaval, Distayne, Storyboard, Castle Blaster, Skybreak, & Azure Spark
Romantic Story - Trinergy
Run Away From Me - DotEXE
Sahara - Soltan
Sakura VIP - NUU$HI
SALT - Dubloadz
sapience - euphorian & grape milk
Send It - 12th Planet, Barely Alive, PhaseOne
Shadow People - Eptic
Shattered - Ace Aura & Nytrix
Shelter - ATLiens
Silence is Golden - Dodge & Fuski
Skettee Riddim - Loompaskettee
STANKY LEG - BUNDA
Star Force - Voltra
State of Emergency - PhaseOne & YOOKiE
Stay With Me - Diamond Eyes & Christina Grimmie
Sunshine - Syzy
Tear It Up - Eliminate & Shaquille O'Neal
The Record Shop - Ponicz
Toll Gate - Akeos & Ayonikz
Transformations - Rameses B & Laura Brehm
Umbra - Marauda
Wacky Slime - MAD DUBZ
Walls Cave In - Soltan & NAZAAR
Wasted - eugene
We Don't Play - Disciple
WTF - Herobust
Zoom - Spag Heddy